0000000000
0111111110
0100000010
0100000010
0100000010
0100000010
0100000010
0100000010
0100000010
0000000000