0000000000
0111111110
0111111110
0111111110
0111001110
0111001110
0111111110
0111111110
0111111110
0000000000