0000000000
0111111110
0000110000
0000110000
0000110000
0000110000
0000110000
0000110000
0000110000
0000110000