[
    {
        "nombre": "Nivel1-Nieve",
        "matriz": [
            [0,0,0,0,0,0,0,0,0,0],
            [0,1,1,1,1,1,1,1,1,0],
            [0,0,0,0,0,0,0,0,0,0],
            [0,0,0,0,0,0,0,0,0,0],
            [0,0,0,0,0,0,0,0,0,0],
            [0,0,0,0,0,0,0,0,0,0],
            [0,0,0,0,0,0,0,0,0,0],
            [0,0,0,0,0,0,0,0,0,0],
            [0,0,0,0,0,0,0,0,0,0],
            [0,0,0,0,0,0,0,0,0,0]
        ],
        "contrarreloj": 3
    },
    {
        "nombre": "Nivel2-Nieve",
        "matriz": [
            [0,0,0,0,0,0,0,0,0,0],
            [0,1,1,1,1,1,1,1,1,0],
            [0,1,0,0,0,0,0,0,1,0],
            [0,1,0,0,0,0,0,0,1,0],
            [0,1,0,0,0,0,0,0,1,0],
            [0,1,0,0,0,0,0,0,1,0],
            [0,1,0,0,0,0,0,0,1,0],
            [0,1,0,0,0,0,0,0,1,0],
            [0,1,1,1,1,1,1,1,1,0],
            [0,0,0,0,0,0,0,0,0,0]
        ],
        "contrarreloj": 8
    },
    {
        "nombre": "Nivel3-Nieve",
        "matriz": [
            [0,0,0,0,0,0,0,0,0,0],
            [0,1,1,1,1,1,1,1,1,0],
            [0,0,0,0,1,1,0,0,0,0],
            [0,0,0,0,1,1,0,0,0,0],
            [0,0,0,0,1,1,0,0,0,0],
            [0,0,0,0,1,1,0,0,0,0],
            [0,0,0,0,1,1,0,0,0,0],
            [0,0,0,0,1,1,0,0,0,0],
            [0,0,0,0,1,1,0,0,0,0],
            [0,0,0,0,1,1,0,0,0,0]
        ],
        "contrarreloj": 7
    },
    {
        "nombre": "Nivel4-Nieve",
        "matriz": [
            [0,0,0,0,0,0,0,0,0,0],
            [0,1,1,1,1,1,1,1,1,0],
            [0,1,1,1,1,1,1,1,1,0],
            [0,1,1,1,1,1,1,1,1,0],
            [0,1,1,1,1,1,1,1,1,0],
            [0,1,1,1,1,1,1,1,1,0],
            [0,1,1,1,1,1,1,1,1,0],
            [0,1,1,1,1,1,1,1,1,0],
            [0,1,1,1,1,1,1,1,1,0],
            [0,0,0,0,0,0,0,0,0,0]
        ],
        "contrarreloj": 8
    },
    {
        "nombre": "Nivel5-Nieve",
        "matriz": [
            [0,0,0,0,0,0,0,0,0,0],
            [0,1,1,1,1,1,1,1,1,0],
            [0,1,1,1,1,1,1,1,1,0],
            [0,0,0,0,0,0,0,0,0,0],
            [0,0,0,0,0,0,0,0,0,0],
            [0,0,0,0,0,0,0,0,0,0],
            [0,0,0,0,0,0,0,0,0,0],
            [0,0,0,0,0,0,0,0,0,0],
            [0,0,0,0,0,0,0,0,0,0],
            [0,0,0,0,0,0,0,0,0,0]
        ],
        "contrarreloj": 4
    },
    {
        "nombre": "Nivel6-Nieve",
        "matriz": [
            [0,0,0,0,0,0,0,0,0,0],
            [0,1,1,1,1,1,1,1,1,0],
            [0,1,0,0,0,0,0,0,1,0],
            [0,1,0,0,0,0,0,0,1,0],
            [0,1,0,0,0,0,0,0,1,0],
            [0,1,0,0,0,0,0,0,1,0],
            [0,1,0,0,0,0,0,0,1,0],
            [0,1,0,0,0,0,0,0,1,0],
            [0,1,0,0,0,0,0,0,1,0],
            [0,0,0,0,0,0,0,0,0,0]
        ],
        "contrarreloj": 8
    },
    {
        "nombre": "Nivel7-Nieve",
        "matriz": [
            [0,1,1,1,1,1,1,1,1,0],
            [0,1,1,1,1,1,1,1,1,0],
            [0,0,0,0,1,1,0,0,0,0],
            [0,0,0,0,1,1,0,0,0,0],
            [0,0,0,0,1,1,0,0,0,0],
            [0,0,0,0,1,1,0,0,0,0],
            [0,0,0,0,1,1,0,0,0,0],
            [0,0,0,0,1,1,0,0,0,0],
            [0,1,1,1,1,1,1,1,1,0],
            [0,1,1,1,1,1,1,1,1,0]
        ],
        "contrarreloj": 15
    },
    {
        "nombre": "Nivel8-Nieve",
        "matriz": [
            [1,1,0,0,1,1],
            [1,1,0,0,1,1],
            [0,0,0,0,0,0],
            [1,0,0,0,0,1],
            [0,1,0,0,1,0],
            [0,0,1,1,0,0]
        ],
        "contrarreloj": 15
    },
    {
        "nombre": "Nivel9-Nieve",
        "matriz": [
            [0,0,0,0,0,0,0,0,0,0],
            [0,1,1,1,1,1,1,1,1,0],
            [0,0,0,0,0,0,0,0,0,0],
            [0,1,1,1,1,1,1,1,1,0],
            [0,2,2,2,2,2,2,2,2,0],
            [0,2,2,4,4,4,4,2,2,0],
            [0,2,2,2,2,2,2,2,2,0],
            [0,0,0,3,3,3,3,0,0,0],
            [0,3,3,4,4,4,4,3,3,0],
            [0,0,0,3,3,3,3,0,0,0]
        ],
        "contrarreloj": 20
    }
]